TGGAGATGGAAGCCG	TGGAGATCGAAGCCG
CCAGGGAACAGATTT	CCAGGGAGCAGATTT
TACTTCTGTCACTCT	TACTTCTCTCACTCT
AGCAAGAACTATTTT	AGCAAGAGCTATTTT
TTTATTCCGTTCACT	TTTATTCAGTTCACT
TGGGGAAATTAATGG	TGGGGAAGTTAATGG
ACTGGGCACCCAGGG	ACTGGGCCCCCAGGG
CAGGGACTCAATGAT	CAGGGACGCAATGAT
AGATCACAGCACTGA	AGATCACGGCACTGA
ATTCCAGAAACGTCT	ATTCCAGGAACGTCT
AGCTTTCAATTTCAA	AGCTTTCGATTTCAA
TATTCTCACCATTCC	TATTCTCGCCATTCC
ACACCCTGGACATCT	ACACCCTCGACATCT
GGGAGCCAACTCTGG	GGGAGCCGACTCTGG
TAGCACCATTTGTTA	TAGCACCGTTTGTTA
AGCCACCATACCTGG	AGCCACCGTACCTGG
TCATAGATCCTTTCT	TCATAGACCCTTTCT
TAAGTTATGTAAACT	TAAGTTACGTAAACT
TTTCACTACTGGGAG	TTTCACTCCTGGGAG
CTTGTTATATTTTTT	CTTGTTACATTTTTT
GCCACTCTCTATACC	GCCACTCCCTATACC
CGAGGGTCATTTTCA	CGAGGGTTATTTTCA
GTGACCCGGTAAGTG	GTGACCCAGTAAGTG
ACTCCAAGATACAAA	ACTCCAAAATACAAA
ATATATTCGCTTTCT	ATATATTTGCTTTCT
GATGGCCATGGAGTC	GATGGCCGTGGAGTC
AGAAGGAGGCAGCCA	AGAAGGACGCAGCCA
TTACCTCGGCATAAC	TTACCTCAGCATAAC
GAAATCCCGTCTCTA	GAAATCCTGTCTCTA
AAAAAAGGCAAGAAA	AAAAAAGACAAGAAA
CAGTGGCGCGATCTC	CAGTGGCACGATCTC
CAAGGCTGCAGTGAG	CAAGGCTACAGTGAG
TCACTGGTAGGCACA	TCACTGGCAGGCACA
CAAATTAGTCTCTGC	CAAATTAATCTCTGC
CCCTGAAGTTAATAC	CCCTGAACTTAATAC
AACCCCCAAATCTCT	AACCCCCGAATCTCT
TGGATACATCCTTCT	TGGATACCTCCTTCT
TAATAATAATTATTG	TAATAATTATTATTG
CAAAGTTTTATTGTA	CAAAGTTGTATTGTA
GGTGGAGCGTAAGCA	GGTGGAGTGTAAGCA
AAGCCCCCGCGGAAG	AAGCCCCTGCGGAAG
CACCTTCTCAGAATG	CACCTTCCCAGAATG
